###################
#=.       =   ....#
#.# # ###### #.##.#
#.#o# #   o# #.o#.#
#.###.#  ### #..#.#
#.....  /    #..#=#
####################
