###################
#=.       =   ....#
#.# # ###### #.##.#
#.#o# #   o# #.o#.#
#.###.#  ### #..#.#
#.....  \    #..#=#
####################
