####################
#o...#........#...o#
#.##.#.##..##.#.##.#
#...... = ==#......#
#.#.##.## ###.##.#.#
#.#....# ooo#.#..#.#
#.#.##.# ## #.#.##.#
#o#......\....#....#
####################
