####################
#o...#........#...o#
#.##.#.##..##.#.##.#
#...... = ==#......#
#.#.##.## ###.##.#.#
#.#....# ooo#.#..#.#
#.#.##.# ## #.#.##.#
#o#....../....#....#
####################
