####################
#o...#........#....#
#.##.#.######.#.##.#
#.#..............#.#
#.#.##.##  ##.##.#.#
#......#=  =#......#
#.#.##.######.##.#.#
#.#..............#.#
#.##.#.######.#.##.#
#....#.../....#...o#
####################
