#########
#.\    =# 
# #.#=###  
#=    ### 
#########
