#########
#./    =# 
# #.#=###  
#=    ### 
#########
