#########################
#.. \  ....      ....   #
#..  ...  ...  ...  ... #
#..  ...  ...  ...  ... #
#..    ....      .... = #
#..  ...  ...  ...  ... #
#..  ...  ...  ...  ... #
#..    ....      ....  o#
#########################
