#########################
#.. /  ....      ....   #
#..  ...  ...  ...  ... #
#..  ...  ...  ...  ... #
#..    ....      .... = #
#..  ...  ...  ...  ... #
#..  ...  ...  ...  ... #
#..    ....      ....  o#
#########################
