####################
#......#=  =#......#
#.##...##  ##...##.#
#.#o.#........#.o#.#
#.##.#.######.#.##.#
#........\.........#
####################
