####################
#......#=  =#......#
#.##...##  ##...##.#
#.#o.#........#.o#.#
#.##.#.######.#.##.#
#......../.........#
####################
