#####
# . #
#.=.#
# . #
#. .#
#   #
#  .#
#   #
#/ .#
#####
