########
#   \ =#
#=######
#....  #
########
