########
#   / =#
#=######
#....  #
########
